"TITULACIONES","PLAZAS OFERTADAS","CUPO GENERAL","MAYORES 25","TITULADOS","DEPORTISTAS","DISCAP.","MAYORES 40 Y 45","MATRIC. TOTALES"
"ADMINISTRACION Y DIRECCION DE EMPRESAS",281,275,6,3,1,1,0,286
"ADMINISTRACION Y DIRECCION DE EMPRESAS (CEUTA)",70,45,2,0,0,0,2,49
"ADMINISTRACION Y DIRECCION DE EMPRESAS (MELILLA)",70,45,0,1,0,1,0,47
"ADMINISTRACION Y DIRECCION DE EMPRESAS + DERECHO",143,144,1,2,0,0,0,147
"ADMINISTRACION Y DIRECCION DE EMPRESAS + DERECHO (MELILLA)",60,41,2,0,0,0,0,43
"ANTROPOLOGIA SOCIAL Y CULTURAL",65,58,0,1,0,0,2,61
"ARQUEOLOGIA",65,63,1,1,0,0,0,65
"ARQUITECTURA",160,143,2,3,0,1,0,149
"BELLAS ARTES",235,224,5,3,0,3,0,235
"BIOLOGIA",210,213,0,2,0,1,0,216
"BIOQUIMICA",55,53,0,1,0,2,0,56
"BIOTECNOLOGIA",50,50,0,1,1,1,2,55
"CIENCIAS AMBIENTALES",150,142,1,1,0,1,0,145
"CIENCIAS DE LA ACTIVIDAD FISICA Y DEL DEPORTE",190,175,4,3,8,2,0,192
"CIENCIAS DE LA ACTIVIDAD FISICA Y DEL DEPORTE+ EDUCACION PRIMARIA   (MELILLA)",65,60,1,2,0,1,0,64
"CIENCIAS POLITICAS Y DE LA ADMINISTRACION",150,142,3,2,0,1,2,150
"CIENCIAS POLITICAS Y DE LA ADMINISTRACION + DERECHO",145,141,2,2,0,1,0,146
"CIENCIAS Y TECNOLOGIA DE LOS ALIMENTOS",65,63,0,1,0,0,0,64
"COMUNICACION AUDIOVISUAL",65,62,2,0,0,1,0,65
"CONSERVACION Y RESTAURACION DE BIENES CULTURALES",50,50,1,1,0,0,0,52
"CRIMINOLOGIA",75,73,2,1,0,1,2,79
"DERECHO",500,478,10,5,1,3,8,505
"ECONOMIA",237,235,2,0,0,0,0,237
"EDIFICACION ",250,83,0,0,0,0,2,85
"EDUCACION INFANTIL  (CIENCIAS DE LA EDUCACION)",330,319,6,4,1,1,1,332
"EDUCACION INFANTIL (C. MAGISTERIO INMACULADA)",130,84,0,0,0,0,0,84
"EDUCACION INFANTIL (CEUTA)",70,41,1,1,0,0,0,43
"EDUCACION INFANTIL (MELILLA)",65,28,0,1,0,0,0,29
"EDUCACION PRIMARIA (CIENCIAS DE LA EDUCACION)",540,520,10,6,1,2,0,539
"EDUCACION PRIMARIA  (C. MAGISTERIO INMACULADA)",220,147,3,11,0,0,0,161
"EDUCACION PRIMARIA (BILINGÃœE)",67,64,2,1,0,1,0,68
"EDUCACION PRIMARIA (CEUTA)",140,61,1,6,0,0,0,68
"EDUCACION PRIMARIA (MELILLA)",65,43,0,4,0,0,0,47
"EDUCACION SOCIAL (CIENCIAS DE LA EDUCACION)",135,133,3,2,0,2,1,141
"EDUCACION SOCIAL (CEUTA)",80,47,3,0,0,0,0,50
"EDUCACION SOCIAL (MELILLA)",80,30,0,0,0,0,0,30
"ENFERMERIA",200,186,4,2,1,3,4,200
"ENFERMERIA (CEUTA)",135,139,3,1,0,0,1,144
"ENFERMERIA (MELILLA)",110,108,3,1,0,1,0,113
"ESTADISTICA",60,61,0,0,0,0,0,61
"ESTUDIOS ARABES E ISLAMICOS",50,34,2,1,0,0,0,37
"ESTUDIOS FRANCESES",75,69,1,0,0,0,2,72
"ESTUDIOS INGLESES",150,151,0,2,0,0,0,153
"FARMACIA",320,316,1,3,0,2,0,322
"FILOLOGIA CLASICA",50,35,0,3,0,0,0,38
"FILOLOGIA HISPANICA",75,73,1,1,0,1,1,77
"FILOSOFIA",80,78,1,0,0,0,0,79
"FINANZAS Y CONTABILIDAD",129,127,2,1,0,0,0,130
"FISICA",130,129,0,2,0,1,0,132
"FISIOTERAPIA",60,56,2,0,7,1,2,68
"GEOGRAFIA Y GESTION DEL TERRITORIO",60,48,2,0,0,0,0,50
"GEOLOGIA",75,71,2,1,0,1,1,76
"HISTORIA",150,141,3,2,0,1,2,149
"HISTORIA DEL ARTE",150,133,1,1,0,0,2,137
"HISTORIA Y CIENCIAS DE LA MUSICA",65,63,2,1,0,0,0,66
"INFORMACION Y DOCUMENTACION",100,47,1,4,0,0,1,53
"INGENIERIA  DE TECNOLOGIAS DE TELECOMUNICACION",100,99,1,0,1,0,0,101
"INGENIERIA CIVIL",200,172,1,1,0,0,0,174
"INGENIERIA ELECTRONICA INDUSTRIAL",65,65,1,1,0,0,0,67
"INGENIERIA INFORMATICA",300,294,2,3,0,1,0,300
"INGENIERIA INFORMATICA + MATEMATICAS",50,50,0,1,0,0,0,51
"INGENIERIA INFORMATICA (CEUTA)",50,18,1,0,0,0,0,19
"INGENIERIA QUIMICA",120,118,0,2,0,1,0,121
"LENGUAS MODERNAS Y SUS LITERATURAS",75,72,0,1,0,0,0,73
"LITERATURAS COMPARADAS",50,44,0,1,0,0,0,45
"LOGOPEDIA",70,69,2,1,0,0,0,72
"MARKETING E INVESTIGACION DE MERCADOS",129,127,3,1,0,0,0,131
"MATEMATICAS",110,107,0,1,0,0,0,108
"MEDICINA",253,221,7,3,7,13,3,254
"NUTRICION HUMANA Y DIETETICA",100,94,2,1,1,1,0,99
"ODONTOLOGIA",85,82,2,1,0,1,1,87
"OPTICA Y OPTOMETRIA",135,132,2,1,0,0,0,135
"PEDAGOGIA",135,136,0,1,0,0,0,137
"PSICOLOGIA",300,284,6,3,4,3,2,302
"QUIMICA",90,89,2,1,0,0,0,92
"RELACIONES LABORALES Y RECURSOS HUMANOS",365,331,8,2,0,0,2,343
"RELACIONES LABORALES Y RECURSOS HUMANOS (MELILLA)",50,17,0,3,0,0,0,20
"SOCIOLOGIA",160,150,3,2,0,1,0,156
"TERAPIA OCUPACIONAL",60,60,2,1,0,0,2,65
"TRABAJO SOCIAL",180,173,4,1,0,2,2,182
"TRADUCCION E INTERPRETACION (ALEMAN)",37,38,0,0,0,0,0,38
"TRADUCCION E INTERPRETACION (ARABE)",35,37,1,0,0,0,0,38
"TRADUCCION E INTERPRETACION (FRANCES)",80,80,0,1,0,0,0,81
"TRADUCCION E INTERPRETACION (INGLES)",120,110,4,2,0,3,1,120
"TURISMO",144,142,1,2,0,0,0,145
